Md, Md, Md, Md, Md, Md, Md, Md, Md, Gs^Fds, Md
Md, Md, Md, Md, Cud, Md, Md, Md, Md, Md, Md
Md, Md, Md, Cud, 1 Kud, Cud, Md, Md, Md, Md, Md
Md, Md, Md, Cud, Cud, Cud, Md, Md, Md, Md, Md
Md, Md, Md, Md, Md, Md, Md, Md, Md, Md, Md
Md, Md, Md, Md, Md, Md, Md, Md, Md, Md, Md
Md, Md, Md, Md, Md, Md, Md, Md, Md, Md, Md
Md, Md, Md, Md, Md, Md, Md, Md, Md, Md, Md
Md, Md, Md, Md, Md, Md, Md, Md, Md, Md, Md
