Irs, Irs, Irs, Irs, Irs, Irs, Irs, Irs
Irs, Irs, Irs, Irs, Irs, Irs, Irs, Irs
Irs, Irs, Irs, Irs, Irs, Irs, Irs, Irs
Irs, Irs, Irs, Irs, 1 Irs, Irs, Irs, Irs
Irs, Irs, Irs, Irs, Irs, Irs, Irs, Irs
Irs, Irs, Irs, Irs, Irs, Irs, Irs, Irs
Irs, Irs, Irs, Irs, Irs, Irs, Irs, Irs
Irs, Irs, Irs, Irs, Irs, Irs, Irs, Irs
