Hh, Hh, Hh, Gs^Fds, Hh, Gg, Hh, Rr, Hh, Gs^Fds, Hh
Hh, Hh, Hh, Hh, Co, Hh, Hh, Hh, Hh, Hh, Hh
Hh, Hh, Hh, Co, 1 Ko, Co, Hh, Hh, Hh, Hh, Hh
Hh, Hh, Hh, Co, Co, Co, Hh, Hh, Hh, Hh, Hh
Hh, Hh, Hh, Hh, Hh, Hh, Hh, Hh, Hh, Hh, Hh
Hh, Hh, Hh, Hh, Hh, Hh, Hh, Hh, Hh, Hh, Hh
Hh, Hh, Hh, Hh, Hh, Hh, Hh, Hh, Hh, Hh, Hh
Hh, Hh, Hh, Hh, Hh, Hh, Hh, Hh, Hh, Hh, Hh
Hh, Hh, Hh, Hh, Gs^Fds, Hh, Hh, Hh, Hh, Hh, Hh
